Top words for class  0	Top words for class  1
获得	大多數
发展部	這些
华彩	當地
成为	開始
选角于	設有
一个	臺灣
纽约	朝陽區
群岛	之後
洗发水	當時
这种	石家莊
这个	阿猴廳
朝阳区	這個
合成词	使用
狮子	包括
支撑	計畫
世纪	寫道
台湾	汪東城
中国	他們
历史	石家莊市
发剂	辛普森
开始	總部
设计	拍攝
时期	山地
高雄	步調
美国	印表機
时间	地區
长荣	行政區
位于	北部
离开	並於
其他	可以
他们	客機
生产	外國
鼠标	傑出
大学	成為
菠萝	發展
不复存在	出現
航空	波音
现场	雲南
阿猴厅
为止
通过