italia	òrdini	cronològgicu	lista di li tirrimoti abbinuti n italia n òrdini cronològgicu
assaimeteoruluggìa	si	fu	pi esempiu si dici ieri ci fu acqua assaimeteoruluggìa
supratuttu	comu	riliggiusa	supratuttu comu guida riliggiusa sutta li papintê sèculi chi vìnniru
currispunni	lu	è	currispunni â distanza tra lu suli e la terra chi è di circa miliuna di chilomitri
ti	di	sòlitu	ti di sòlitu cumprisa tra li e li km
dâ	citàcanusciuta	lorganizzazzioni	ti uccidintali dâ citàcanusciuta pi lorganizzazzioni ntirnazziunali ca hannu scigghiu
rajneesh	cu	rifirimentu	u bs rajneesh cu rifirimentu ô culuri dâ tùnica nnussata
custruèru	lu	chiamatu	lu paisi chiamatu anticamenti garinis lu custruèru l
jinnaru	artìculu	dâ	unali siciliana lu di jinnaru dû n artìculu aduzzioni dâ bannera la bannera dâ riggiuni è furmata dun
facennu	installazzioni	o	bbili facennu sabutaggiu di installazzioni o attinta
timeu	ntô	grecu	u grecu timeu di tauromeniu ntô ac
dâ	nnô	pirìudu	stòrialuriggini dâ cità di scicli si pò allucari nnô pirìudu iii sìculu ca cumprenni lanni dô aprima di cristu nzinu a l ac
puru	comu	fu	billie holiday di aprili di giugnettu canusciuta puru comu lady day fu una
cristu	grazzia	dô	ricustruitu ntô doppu cristu pi grazzia dô mpiraturi adrianu
cunziddirari	dô	paisi	i furu additicati na chiazza dô paisi e la marcia ca si pò cunziddirari l
cumulunemmi	ginìranu	ascinziunali	ê misi càudiô nternu di li cumulunemmi si ginìranu currenti ascinziunali di nutèvuli ntinzitati macari di m
cutuliati	ditti	macari	quarchi minutuli cutuliati di tirrimotu sunnu urizzuntali ditti macari unnulatorî e virticali ditti macari sussurtorî nu tirrimotu pò èssiri furmatu di cu
succidìa	lu	culusseu	sta cosa succidìa sulu tra cristiani lu culusseu co
n	tipu	nesprissiuni	n matimàtica na seri è nesprissiuni dû tipu
ntonzi	addiventa	capitali	roma addiventa ntonzi la capitali di litalia
curputu	sunnu	dâ	ahoma city lu paisi cchiù curputu di li turnatu sunnu lusa e n particulari la zona dâ tornado alley ntô midwest si svilùppanu comu è gghiè a
dâ	versu	sèculu	rinascimentu e umanesimufu sulu a pàrtiri dâ fini dû mediu evu versu lu sèculu xiv ca roma accuminza nàutra vota a affirmàrisi
sèppiru	sutta	ssa	appoi macari scìchili appi a cascari sutta a l angiuini e sutta a ssa duminazzioni sèppiru moti contru ê francisi dopu lu famu
appari	giarnu	leffettu	e chi appari giarnu sulu pi leffettu di assorbiment
cumbattìvanu	spissu	nudi	cumbattìvanu tra di iddi o chî bestî spissu a manu nudi o cu armi ruggiati