della	verbale	sarà	il processo verbale della seduta di oggi sarà sottoposto allapprovazione del parlamento nella prossima tornata
obiettivi	sono	accettare	possiamo solo accettare obiettivi vincolanti se sono realizzabili
loro	abbiamo	queste	abbiamo bisogno di entrambe e queste a loro volta si sosterranno a vicenda
commissione	impone	la	la commissione non impone di farlo
il	danno	positivo	il secondo timore è che nel tentativo di compiere qualcosa di positivo faremo qualche danno
si	mondo	il	nellultimo decennio il mondo non si è riscaldato
responsabilità	paesi	secondo	il secondo punto è che limposizione di oneri elevati per alcuni paesi non significa minore responsabilità per altri
sia	una	la	non sosteniamo che la soluzione migliore sia una piuttosto che laltra
emissioni	kyoto	protocollo	inoltre il protocollo di kyoto attraverso gli scambi di quote di emissioni ha creato un nuovo mercato capitalistico
progetto	modesto	è	per quanto attiene al progetto galileo il cui sviluppo è stato finora modesto dato che non
droghe	popolazione	di	ovviamente dovremmo in primo luogo cercare di persuadere la popolazione a non far uso di droghe illegali
iniziato	governi	finlandese	i governi ragionevoli quali quello finlandese o britannico hanno già iniziato a muoversi in questo senso
necessita	della	competitività	primo la competitività ha bisogno della sostenibilità ma lo stesso vale per la sostenibilità che necessita della competitività
azione	saranno	questa	tutti saranno coinvolti in questa azione
riguarda	per	commissione	accolgo con favore gli sforzi della commissione per quanto riguarda la cooperazione internazionale e la legislazione interna
voto	processo	verbale	correzioni e intenzioni di voto vedasi processo verbale
presidente	obiettivi	andare	en signora presidente finalmente ci spostiamo dagli obiettivi per andare verso gli strumenti
paesi	dei	dobbiamo	dobbiamo salire a bordo dei paesi più industrializzati ed è vostro dovere occuparvi di tale aspetto
quello	mill	stuart	talvolta quando si discute di cambiamenti climatici cito quello che john stuart mill disse in merito al padre
allesigenza	sono	di	da vari decenni le democrazie occidentali sono sensibili allesigenza di proteggere lambiente naturale
della	presidente	commissione	hu signora presidente membri della commissione vi ringrazio
sarà	questo	grado	leuropa sarà così in grado di sviluppare questo suo
leuropa	rivoluzione	sensazione	è una sensazione positiva vedere che leuropa sta assumendo un ruolo preminente nella terza rivoluzione industriale
presidente	signora	indicato	en signora presidente ormai quando salta fuori il tema dei cambiamenti climatici viene in genere indicato come riscaldamento globale
rimasta	inalterata	è	negli ultimi nove anni dal la temperatura globale del pianeta è rimasta inalterata